NO ./textures/purplestone.xpm
SO ./textures/greystone.xpm
EA ./textures/eagle.xpm
WE ./textures/red.xpm
S   ./textures/tonneau.xpm
C   255 ,  200  ,   160     
F 122,122,122

        1111111111111111111111111
        1000000000110000000000001
        1011000001110000002000001
        1001000000000000000000001
111111111011000001110000000000001
100000000011000001110111111111111
11110111111111011100000010001
11110111111111011101010010001
11000000110101011100000010001
10002000000000001100000010001
10000000000000001101010000001
11000001110101011111011110W0111
11111111 1110101 101111010001
1111 111 1111111 111111111111